break away (from) - rời bỏ, trốn thoát
breakaway - (a) (phải có danh từ theo sau) độc lập (sau khi tách khỏi một tổ chức, vùng nào đó); (n): sự rời khỏi
break down - hỏng hóc (máy móc), suy sụp (tinh thần); breakdown (n)
broken-down - (a) (xe) bị hư
break in - ngắt lời, chen ngang; đột nhập (nhà cửa)
break-in (n) - cuộc đột nhập
break shoes/boots in - mang giày/ủng vào (wear sth in)
break off with sb - cắt đứt quan hệ với ai, tuyệt giao với ai
breakout - (n) an escape from prison; the separation of information into categories
outbreak - (n) the sudden appearance of sth unpleasant
make a breakthrough - tạo ra một bước đột phá
bring back - đem trả lại, mang trả lại; gợi nhớ (bring memories back)
bring sb before a court - đem ai ra trước phiên tòa = haul sb before a court
bring sb down - khiến ai đó không vui = get sb down, depress sb
bring down the curtain on sth - mark the end of sth
bring sth forward - (1) dời ngày lên sớm hơn (meeting, date) = put sth forward; đưa ra (proposal) cho một cuộc họp
bring in - đưa vào, mang vào
bring sth off/ come off/ breeze through - thành công
bring sb on - giúp ai đó cải thiện (khi đang học một môn gì đó)
bring sth on - dẫn đến, gây ra, làm cho phải bàn cãi = cause sth
bring sb out - làm cho ai tự tin hơn
bring sth out - nhấn mạnh cái gì đó
bring around/round - làm cho tỉnh lại = make sb conscious again
bring sth round to sb - làm cho ai thay đổi ý kiến theo = win sb over (to sth)
bring conversation/discussion round to sth - hướng cuộc nói chuyện, thảo luận theo một chủ đề nào đó
bring/pull sb through (sth) - giúp ai vượt qua khó khăn, hiểm nghèo
bring sb up - chăm sóc (children/family/daughter/son) = raise sb
bring sth up - đề cập = mention, raise sth
brighten up - tươi tỉnh lên, phấn chấn lên (SYN: cheer up); làm cho nơi nào đó đẹp hơn (place/room)
bristle with sth - be covered with sth; be full of sth
brush sb off - gạt phăng, gạt bỏ = rebuff sb; to get rid of
brush up on sth/ brush sth up - ôn lại, học lại xem lại (skills, France etc.) = polish sth up, review sth, revise sth
blow sb off - coi thường ai đó
blow in - thổi vào, đến bất chợt, đến thình lình
blow out; blow sth out - (lửa) bị thổi tắt; (lốp xe) nổ (= burst suddenly)
blow sb out - dễ dàng đánh bại ai
blowout - sự nổ lốp xe; bữa tiệc
blowout - Một chiến thắng dễ dàng
blow over - (cuộc tranh luận, cãi vã) bị quên đi = subside
blow up - bơm căng lên = inflate sth; phóng lớn (ảnh) = enlarge; phát nổ = explode, go off; (at sb) nổi điên lên
blow up in sb's face - một kế hoạch, một thỏa thuận hoặc một tình huống nào đó của bạn đi sai hướng, thì nó sẽ làm hại hoặc gây khó dễ cho bạn.
bolster sb up - ủng hộ, khuyến khích ai (support, encourage)
bump into - come across, run into sb
catch up (with) - đuổi kịp, bắt kịp
call on/upon sb to do sth - kêu gọi yêu cầu = request sb to do sth, tạt qua thăm = visit
call for - gọi, tìm đến ai để lấy cái gì
call in - mời đến, triệu đến
call off - ngừng = cancel
call up - gọi tên, gọi điện, gọi dậy, gọi nhập ngũ (= conscript sb, draft sb), gợi nhớ lại (= recall sth)
call on - đơn thăm, đề nghị, yêu cầu
come about - xảy ra, xảy đến = happen
come across - tình cờ gặp; (ý tưởng) được diễn đạt rõ ràng, dễ hiểu
come after - theo sau, nối dõi, nối nghiệp, kế tục
come against - đụng phải, va phải
come apart - tách lìa ra, bung ra
come at - nắm được, xông vào
come away - đi xa, đi khỏi
come back - quay trở lại
come between - can thiệp vào, xen vào
come by - đi qua, kiếm được, vớ được
come down - sa sút xuống dốc
come down on/upon - mắng nhiếc xỉ vả trừng phạt
come down with - mắc bệnh
come in - đi vào
come in for - có phần, nhận lấy
come into - được hưởng, thừa kế = inherit
come off - được thực hiện, được hoàn thành
come on - đi tiếp, đi tới, tiến lên
come out - lộ ra, xuất bản
come over - trùm lên, bao trùm
come round - hồi phục
come up - đi đến; xảy ra ( = happen)
come up with - nảy ra, tìm ra ý tưởng
come up to - đạt tới mong đợi
cut away - cắt, chặt đi
cut down - chặt, đốn
cut out - cắt ra, bớt ra
cut up - chỉ trích gay gắt, phê bình nghiêm khắc
cut down on - cắt giảm
carry out - thực hiện, tiến hành
carry over - mang sang bên kia
drop on - mắng nhiếc, sỉ vả, trừng phạt
drop out - bỏ cuộc, bỏ giữa chừng
carry away - mang đi cuốn đi, bị làm cho mê say
carry off - chiếm đoạt, làm cho chấp nhận được, làm cho thông qua được